ALL	AO L
DOOR	D AO R
DOWN	D AW N
EAST	IY S T
INVENTORY	IH N V AX N T AO R IY
KILL	K IH L
LANTERN	L AE N T AXR N
LEAFLET	L IY F L AX T
LOOK	L UH K
MAILBOX	M EY L B AA K S
MOVE	M UW V
NORTH	N AO R TH
OFF	AO F
ON	AA N
ON(2)	AO N
OPEN	OW P AX N
READ	R EH D
READ(2)	R IY D
RUG	R AH G
SAVE	S EY V
SOUTH	S AW TH
SWORD	S AO R D
TAKE	T EY K
TRAP	T R AE P
TROLL	T R OW L
TURN	T ER N
UP	AH P
WEST	W EH S T
WINDOW	W IH N D OW
WITH	W IH DH
WITH(2)	W IH TH
WITH(3)	W IX DH
WITH(4)	W IX TH
